XXXXXXXXXXXXXXXXXXXXXXXXXXXXXXXXXXXXXXXX
X                                      X
X                                      X
X                                      X
X                                      X
XXXXXXXX                        XXXXXXXX
X                                      X
X                                      X
XXXXXXXXXX                    XXXXXXXXXX
X                                      X
X                                      X
XXXXXXXXXXXX                XXXXXXXXXXXX
X                                      X
X                                      X
X           XXXXXX    XXXXXX           X
X                                      X
XXXXXXXXX                      XXXXXXXXX
X              XXXXXXXX                X
X                                      X
XXXXXXXXXXXX               XXXXXXXXXXXXX
X                                      X
X                                      X
XXXXXXXXXXXXXXXXXXXXXXXXXXXXXXXXXXXXXXXX