XXXXXXXXXXXXXXXXXXXXXXXXXXXXXXXXXXXXXXXX
X                                      X
X                                      X
X                                      X
X                                      X
XXXXXXXX                        XXXXXXXX
X                                      X
X                                      X
XXXXXXXXXX                    XXXXXXXXXX
X              XXXXXXXX                X
X                                      X
XXXXXXXXXXX                 XXXXXXXXXXXX
X                                      X
X                                      X
X           XXXXXX     XXXXXX          X
X                                      X
XXXXXXXXXX                     XXXXXXXXX
X              XXXXXXXX                X
X                                      X
XXXXXXXXXXXX               XXXXXXXXXXXXX
X                                      X
X                                      X
XXXXXXXXXXXXXXXXXXXXXXXXXXXXXXXXXXXXXXXX